10.ox
..ooo...o.
..........
oo........
oo.....o..
.ooo......
oo..o..o..
...o...o..
...o....o.
.o......o.
..oo.....o
