10.ox
...o.oooo.
..ooo..o..
..oo.o.oo.
o....o....
.o.oo...o.
....o....o
....ooo...
...o......
........oo
.o.....o..
